40 40
################################
#          #          #        #
#  ####    #                   #
#  #       #          #        #
#          #    #######        #
#          #    #              #
#  #       #                   #
#  ####    #    #######        #
#          #                   #
#          #                   #
#          #                   #
#     #################        #
#          #                   #
#                              #
#  #########    ###########    #
#          #    #              #
#          #    #              #
#  ####    #    ###########    #
#  #       #          #        #
#          #          #        #
#          #          #        #
#  #       #          #        #
#  ####    #          #        #
#          #    ###########    # 
#          #                   # 
#     #################        #
#                     #        #
#  #########          #        #
#          #    #######        #
#          #                   #
#   ###    #                   #
################################
