40 40
################################
#                              #
#                              #
#     #                        #
#      #                       #
#       #                      #
#        #                     #
#         #                    #
#          #                   #
#                   #          #
#           #        #         #
#            #       #         #
#             #                #
#              #     #         #
#                   #          #
#                   #          #
#                   #          #
#                   #          #
#             #     #          #
#            #                 #
#           #       #          #
#          #        #          #
#         #         #          #
#                   #          #
#        #          #  #       #
#       #           #          #
#      #            #          #
#     #             #          #
#                   #          #
#    #              #          #
#   #               #          #
################################


